14
XXXXXXXXXXXX XXXXXXXXXXXX
X          X XX   XX    X
X XXX XXXX   XXXX    XX X
XXXXX X  XXXXX X  XXXXXXX
X      X X X X X X      X
X X XX X X X X X X XX XXX
X X  X     X X     X  X X
X XX XXXXX X X XXXXX XX X
X X  X     X X     X  X X
X XX XXXXX     XXX X XX X
XXXXXXXXXXXXXXXX      X X
XXXXXXXXXXXXXXXXXXXXX X X
X                       X
XXXXXXXXXXXXXXXXXXXXXXXXX



